xxxxxxxxxxxxxxxx
x xxv     s v sx
x xxs  xx   v  x      
x xxv  xx   v  x    
xs     xx   x  x   
xvxxxxxxx   xs x         
xvs  xxvv   x  x    
x       s      x
x  xvvvvvvxxxvvx   
x  xv    x     x   
x     x  s  x fx  
xxxxxxxxxxxxxxxx